{
  "tileset": "Source/tilesheet_packed.png",
  "tileSize": 16,
  "mapSize": {
    "width": 128,
    "height": 128
  },
  "layers": [
    {
      "data": [
        1, 2, 3, 4, 5, 6, 7, 8, 9, 10, 
        11, 12, 30, 22, 52, 72, 2, 1, 1, 1, 
        100, 101, 50, 334, 34, 343, 344, 3232, 430, 220, 
        19, 80, 50, 14, 24, 3, 34, 540, 23, 1, 
        1030, 8001, 90, 402, 22, 4, 5, 1, 1, 1, 
        0, 20, 1000, 3, 3, 3, 33, 3, 303, 10000
      ] 
    }
  ]
}

